# # # B # # C A T
# # # A # # A # #
# M O T H E R # #
# # # # O # # # #
M # # # M O R E #
A P P L E # # # #
P # # # # # # # #